
################
##       #######
## ##### #######
## ##### ####  E
##    ## #### ##
##### ##  ### ##
##### ### ### ##
S ### ### ### ##
# ###   # ### ##
# ##### #     ##
#       ########
################
